111111111111111
10C0C0000C10001
1P0000001111111
1000000CCE11101
111111111111111
