111111111111111
10C0C000CCCCCC1
1P000E010000001
100000000000001
111111111111111
