111111111111111
10C0C000CCCCCC1
1P0000000000001
100000000EC0001
111111111111111
