11111111
10C0C001
1P0000E1
11111111
