11111111
10C0C001
1P000E01
11111111
